11111111111
10P010E0011
1000C001011
11111111111