1111111111111111111111111111111111
10P0101000000100000C010C0000001001
1000C001010C0100000C010C0000001001
10C010C000000100000C010C0000001001
1000C001010C0100000C010C0000001001
10C010C000000100000C010C0000001001
1000C001010C000E000C010C0000001001
1111111111111111111111111111111111