11111111111
100010E0001
10C000P0001
11111111111