1111111111111111111111111111111111
100010100000010E000001000000001001
1000000101000100000001000000001001
1000100000000100000000000000001001
10000001010001000000P0000000000001
1000101000000100000000000000001001
1000000101000000000C010C0000001001
1111111111111111111111111111111111