1111111111111111111111111111111111
100010100000010E000001000000001001
1000000101000100000001000000001001
1000100000000100000000000000001001
1000000101000100000000000000000001
100P101000000100000000000000001001
1000000101000000000C010C0000001001
1111111111111111111111111111111111